1111111111111111111111111111111111111111
10000000000C00000C00000C00000C00000C0011
10000000000C00000C00000C00700C00000C0011
1P00000C00000C00000C00000C00000C00000C11
10000E000000C00000C00000C00000C00000C001
10000000000C00000C00000C00000C00000C0011
10000000000C00000C00000C00000C00000C0011
10000000000C00000C00000C00000C00000C0011
10000000000C00000C00000C00000C00000C0011
10000000000C00000C00000C00000C00000C0011
10000000000C00000C00000C00000C00000C0011
10000000000C00000C00000C00000C00000C0011
1111111111111111111111111111111111111111